#####################
#     #   #   #      
# ### ### ### # ### #
# #   #         # # #
# # ### # ####### # #
# # #   #   #     # #
# ### ####### ##### #
#   # #     # #     #
### # # ### # # #####
#   # #   #   # #   #
# ### ### ##### # # #
# #   #         # # #
# # ### # ######### #
#   #   #       #   #
##### ######### # ###
#   #       # # # # #
# # ####### # # # # #
# # #   #   #       #
# # # # # ####### ###
# #   # #       #   #
# ### # ####### ### #
#   # #         #   #
### ####### ##### ###
# # #       #   #   #
# # # ####### ### ###
# # #   #           #
# # ### ######### # #
# # #   #     #   # #
# # ### # ### #######
#   #   #   #       #
##### ##### ####### #
#     #   #     # # #
# ##### # ##### # # #
# #     # #     #   #
# # ### ### #########
# #   #     # #     #
# ### ##### # # # # #
#     #   #     # # #
####### ##### ### # #
#     #       #   # #
# ### # ####### ### #
# #   # #     #   # #
# # ### # ### ### # #
# # #   #   # # # # #
# # ##### # # # # # #
# # #   # # # # # # #
# # # # # ### # # ###
# # # #     #   #   #
# ### ### # ####### #
# #     # #         #
# # ### # ####### ###
#   #   # #         #
# ### ##### ##### # #
# # #   #   # #   # #
# # ##### ### # ### #
#   #     # #   #   #
##### ##### # # # ###
#     #     # # #   #
# ##### ##### # ### #
# #     # #   #   # #
# # ### # # # ### # #
# #   # # # # # # # #
# ### ### # # # # ###
# #   #   # #   #   #
# # ### ### ####### #
# #   #   # #       #
# ### ### # # ##### #
# #   #     #   #   #
# # # # ####### # ###
#   # #   #     #   #
######### ######### #
#       #     #   # #
# ##### ##### # # # #
#     #       # #   #
# ### ######### ### #
# #           #   # #
# # ######### ### # #
# #         # #   # #
########### # ##### #
#   #   #   #     # #
# # # # # ####### ###
# #   #   #     #   #
# ######### ### ### #
#           #   #   #
############### # ###
#     # #     # # # #
# # # # # ### # # # #
# # # #   #     #   #
### # # ### #########
#   # #   # #       #
# ### ##### ####### #
# # #   #   #     # #
# # # # # # # # # # #
# # # # # # # # #   #
# # # # # # ### #####
#   # # # #   # #   #
##### # # ### # # # #
#     # #   #   # # #
# ####### # ##### # #
#     #   # #   # # #
##### # ### # # # ###
# #   # # #   # #   #
# # ### # ##### # # #
#       #     #   # #
########### # # #####
#   #       # # #   #
# # # ####### # # # #
# #   #   #   #   # #
####### # # ### # # #
#     # # #     # # #
# ### # # ####### # #
# # # # #       # # #
# # # ######### ### #
#   # #             #
##### # ####### # ###
#   #     #     #   #
# # ### ### ####### #
# # # # #     #   # #
# # # # # ### # ### #
# # #   # #   #     #
# # ##### # # # #####
# #   #   # # #     #
# ### # ### # ##### #
# #   #   # # #   # #
# ######### # # # # #
#     # #   # # #   #
##### # # ##### #####
#   # # # #     #   #
# # # # # ######### #
# #     #     #     #
# ##### ##### # #####
#     #         #   #
##### ########### ###
#   #   #   #       #
# ##### ### # ### # #
#   #     #     # # #
### # ### # ### # ###
#   #   # #   # #   #
# ### # # ### # ### #
#     # #     #   # #
####### ######### ###
#     #   #     #   #
# ### ### # ### ### #
# # # #   #   #   # #
# # # # ##### ##### #
#   # #     #       #
# # # ##### # # # ###
# # #       # # #   #
# # ######### # # ###
# #   #   #   # #   #
# ### # # # ####### #
#   # # #   #     # #
##### # ##### # ### #
#     # #     #   # #
# ####### ####### # #
# #   #   #     # # #
# ### # ### ### # ###
# #   #   #   # #   #
# # ##### ### # ### #
# #     # #   #     #
# ##### ### #########
# #       #         #
# # ##### ######### #
# # #   # #     #   #
# # # # # # ### ### #
# # # #   #   #     #
# ### ####### #######
# #   #     #       #
# # ### ### ####### #
# #     # #         #
# ####### ######### #
# #   #             #
# # # ### ### ##### #
#   #     #   # #   #
############### # ###
#     #   #   #   # #
# # # # # # # # ### #
# # # # # # # # #   #
# ### # # # # # # # #
#   #   # # # #   # #
### ##### # ### #####
#   #   #           #
##### # ########### #
#   # #     #     # #
# # # ##### # ### # #
# # #   #   #   # # #
# # ### ######### # #
# #   #     #   # # #
# ### # ### # # # # #
#   # #   # # #   # #
### ### ### # ##### #
#       #           #
######### ### #######
#   #   #   #   #   #
# # # # ##### ### # #
# # # #     #   # # #
# # # ##### ### # # #
# #   #   #   #   # #
# ####### # # ##### #
#^#         #       #
#####################
#####################
